"filename", "language", "SCSS", "JavaScript", "comment", "blank", "total"
"c:\xampp\htdocs\fd\resources\css\ADMIN\CouponCodes\A_couponCodes.scss", "SCSS", 57, 0, 1, 4, 62
"c:\xampp\htdocs\fd\resources\css\ADMIN\CouponCodes\_couponCodeList.scss", "SCSS", 36, 0, 1, 3, 40
"c:\xampp\htdocs\fd\resources\css\ADMIN\_ADMIN.scss", "SCSS", 93, 0, 8, 6, 107
"c:\xampp\htdocs\fd\resources\css\ADMIN\_Navigation.scss", "SCSS", 68, 0, 2, 4, 74
"c:\xampp\htdocs\fd\resources\css\ADMIN\database\A_database.scss", "SCSS", 28, 0, 2, 1, 31
"c:\xampp\htdocs\fd\resources\css\ADMIN\designs\A_designs.scss", "SCSS", 568, 0, 35, 29, 632
"c:\xampp\htdocs\fd\resources\css\ADMIN\engraving\AD_engraving.scss", "SCSS", 3, 0, 2, 1, 6
"c:\xampp\htdocs\fd\resources\css\ADMIN\index\A_index.scss", "SCSS", 44, 0, 2, 6, 52
"c:\xampp\htdocs\fd\resources\css\ADMIN\login\A_login.scss", "SCSS", 88, 0, 2, 10, 100
"c:\xampp\htdocs\fd\resources\css\ADMIN\orders\A_orders.scss", "SCSS", 515, 0, 32, 15, 562
"c:\xampp\htdocs\fd\resources\css\ADMIN\products\A_products.scss", "SCSS", 357, 0, 111, 26, 494
"c:\xampp\htdocs\fd\resources\css\ADMIN\statistics\A_statistics.scss", "SCSS", 35, 0, 1, 2, 38
"c:\xampp\htdocs\fd\resources\css\ADMIN\stripe\A_stripe.scss", "SCSS", 120, 0, 0, 5, 125
"c:\xampp\htdocs\fd\resources\css\ADMIN\testspace\A_testSpace.scss", "SCSS", 13, 0, 11, 4, 28
"c:\xampp\htdocs\fd\resources\css\PUBLIC\_publicMain.scss", "SCSS", 27, 0, 0, 2, 29
"c:\xampp\htdocs\fd\resources\css\PUBLIC\cart\_cartList.scss", "SCSS", 412, 0, 63, 9, 484
"c:\xampp\htdocs\fd\resources\css\PUBLIC\cart\_cartRight.scss", "SCSS", 158, 0, 3, 8, 169
"c:\xampp\htdocs\fd\resources\css\PUBLIC\cart\cart.scss", "SCSS", 142, 0, 43, 9, 194
"c:\xampp\htdocs\fd\resources\css\PUBLIC\checkout\_checkoutAddress.scss", "SCSS", 74, 0, 17, 5, 96
"c:\xampp\htdocs\fd\resources\css\PUBLIC\checkout\_mobileProductOverview.scss", "SCSS", 148, 0, 10, 3, 161
"c:\xampp\htdocs\fd\resources\css\PUBLIC\checkout\_mobileProductOverviewList.scss", "SCSS", 176, 0, 59, 9, 244
"c:\xampp\htdocs\fd\resources\css\PUBLIC\checkout\_rightPart.scss", "SCSS", 196, 0, 6, 8, 210
"c:\xampp\htdocs\fd\resources\css\PUBLIC\checkout\checkout.scss", "SCSS", 305, 0, 29, 23, 357
"c:\xampp\htdocs\fd\resources\css\PUBLIC\checkout\subPages\_Address.scss", "SCSS", 31, 0, 73, 6, 110
"c:\xampp\htdocs\fd\resources\css\PUBLIC\checkout\subPages\_Overview.scss", "SCSS", 61, 0, 13, 3, 77
"c:\xampp\htdocs\fd\resources\css\PUBLIC\checkout\subPages\_Payment.scss", "SCSS", 134, 0, 6, 20, 160
"c:\xampp\htdocs\fd\resources\css\PUBLIC\checkout\subPages\_Sending.scss", "SCSS", 51, 0, 28, 6, 85
"c:\xampp\htdocs\fd\resources\css\PUBLIC\converterStart\_projectDetails.scss", "SCSS", 43, 0, 60, 7, 110
"c:\xampp\htdocs\fd\resources\css\PUBLIC\converterStart\converterStart.scss", "SCSS", 503, 0, 93, 21, 617
"c:\xampp\htdocs\fd\resources\css\PUBLIC\converterStart\desktop\_Categories.scss", "SCSS", 224, 0, 7, 4, 235
"c:\xampp\htdocs\fd\resources\css\PUBLIC\converterStart\desktop\_projectDetails.scss", "SCSS", 541, 0, 83, 21, 645
"c:\xampp\htdocs\fd\resources\css\PUBLIC\converterStart\desktop\_projects.scss", "SCSS", 210, 0, 42, 13, 265
"c:\xampp\htdocs\fd\resources\css\PUBLIC\converterStart\mobile\_Categories.scss", "SCSS", 245, 0, 43, 8, 296
"c:\xampp\htdocs\fd\resources\css\PUBLIC\converterStart\mobile\_projectDetails.scss", "SCSS", 363, 0, 35, 17, 415
"c:\xampp\htdocs\fd\resources\css\PUBLIC\converterStart\mobile\_projectList.scss", "SCSS", 167, 0, 61, 13, 241
"c:\xampp\htdocs\fd\resources\css\PUBLIC\converter\DOMConverter\_DOMConverterMAIN.scss", "SCSS", 71, 0, 2, 2, 75
"c:\xampp\htdocs\fd\resources\css\PUBLIC\converter\converter.scss", "SCSS", 520, 0, 17, 21, 558
"c:\xampp\htdocs\fd\resources\css\PUBLIC\converter\elements\_EditorFrame.scss", "SCSS", 61, 0, 0, 3, 64
"c:\xampp\htdocs\fd\resources\css\PUBLIC\converter\elements\_EditorFrameMobile.scss", "SCSS", 69, 0, 0, 2, 71
"c:\xampp\htdocs\fd\resources\css\PUBLIC\converter\elements\_LeftBar.scss", "SCSS", 253, 0, 31, 18, 302
"c:\xampp\htdocs\fd\resources\css\PUBLIC\converter\elements\_RightBar.scss", "SCSS", 133, 0, 1, 7, 141
"c:\xampp\htdocs\fd\resources\css\PUBLIC\converter\toolBar\_converterToolBar.scss", "SCSS", 257, 0, 14, 17, 288
"c:\xampp\htdocs\fd\resources\css\PUBLIC\converter\toolBar\_converterToolBarHelper.scss", "SCSS", 163, 0, 12, 6, 181
"c:\xampp\htdocs\fd\resources\css\PUBLIC\converter\toolBar\_converterToolBar_Image.scss", "SCSS", 211, 0, 32, 8, 251
"c:\xampp\htdocs\fd\resources\css\PUBLIC\converter\toolBar\_converterToolBar_Text.scss", "SCSS", 161, 0, 128, 11, 300
"c:\xampp\htdocs\fd\resources\css\PUBLIC\converter\toolBar\bottomBar\_BottomBar.scss", "SCSS", 321, 0, 9, 17, 347
"c:\xampp\htdocs\fd\resources\css\PUBLIC\converter\toolBar\bottomBar\_floatingDiv.scss", "SCSS", 449, 0, 17, 14, 480
"c:\xampp\htdocs\fd\resources\css\PUBLIC\converter\toolBar\bottomBar\_image.scss", "SCSS", 71, 0, 0, 2, 73
"c:\xampp\htdocs\fd\resources\css\PUBLIC\converter\toolBar\bottomBar\_text.scss", "SCSS", 71, 0, 2, 4, 77
"c:\xampp\htdocs\fd\resources\css\PUBLIC\imprint\imprint.scss", "SCSS", 79, 0, 12, 7, 98
"c:\xampp\htdocs\fd\resources\css\PUBLIC\index\_overlay.scss", "SCSS", 240, 0, 1, 9, 250
"c:\xampp\htdocs\fd\resources\css\PUBLIC\index\index.scss", "SCSS", 246, 0, 103, 17, 366
"c:\xampp\htdocs\fd\resources\css\PUBLIC\login\login.scss", "SCSS", 86, 0, 1, 8, 95
"c:\xampp\htdocs\fd\resources\css\PUBLIC\paymentComplete\paymentComplete.scss", "SCSS", 80, 0, 129, 21, 230
"c:\xampp\htdocs\fd\resources\css\PUBLIC\profile\profile.scss", "SCSS", 34, 0, 82, 22, 138
"c:\xampp\htdocs\fd\resources\css\PUBLIC\profile\subPages\_AccountInformation.scss", "SCSS", 64, 0, 6, 3, 73
"c:\xampp\htdocs\fd\resources\css\PUBLIC\profile\subPages\_Adresses.scss", "SCSS", 3, 0, 63, 2, 68
"c:\xampp\htdocs\fd\resources\css\PUBLIC\profile\subPages\_Designs.scss", "SCSS", 17, 0, 4, 2, 23
"c:\xampp\htdocs\fd\resources\css\PUBLIC\profile\subPages\_Images.scss", "SCSS", 56, 0, 7, 2, 65
"c:\xampp\htdocs\fd\resources\css\PUBLIC\profile\subPages\_Orders.scss", "SCSS", 13, 0, 0, 2, 15
"c:\xampp\htdocs\fd\resources\css\PUBLIC\profile\subPages\_Sparks.scss", "SCSS", 1, 0, 0, 0, 1
"c:\xampp\htdocs\fd\resources\css\designs\designs.scss", "SCSS", 318, 0, 8, 38, 364
"c:\xampp\htdocs\fd\resources\css\general\CookieBanner\_CookieBanner.scss", "SCSS", 270, 0, 20, 13, 303
"c:\xampp\htdocs\fd\resources\css\general\Footer\FooterDesktop.scss", "SCSS", 53, 0, 12, 2, 67
"c:\xampp\htdocs\fd\resources\css\general\Footer\FooterMobile.scss", "SCSS", 63, 0, 1, 2, 66
"c:\xampp\htdocs\fd\resources\css\general\NavigationBar\_NavigationBar.scss", "SCSS", 390, 0, 46, 18, 454
"c:\xampp\htdocs\fd\resources\css\general\_3D.scss", "SCSS", 22, 0, 2, 3, 27
"c:\xampp\htdocs\fd\resources\css\general\_buttons.scss", "SCSS", 65, 0, 10, 7, 82
"c:\xampp\htdocs\fd\resources\css\general\_cursor.scss", "SCSS", 30, 0, 2, 1, 33
"c:\xampp\htdocs\fd\resources\css\general\_main.scss", "SCSS", 258, 0, 55, 26, 339
"c:\xampp\htdocs\fd\resources\css\general\_mediaQueries.scss", "SCSS", 21, 0, 49, 29, 99
"c:\xampp\htdocs\fd\resources\css\general\fontfaces.scss", "SCSS", 63, 0, 79, 13, 155
"c:\xampp\htdocs\fd\resources\css\general\fonts.scss", "SCSS", 1020, 0, 126, 150, 1296
"c:\xampp\htdocs\fd\resources\css\imageMenu\_imageMenu.scss", "SCSS", 12, 0, 2, 4, 18
"c:\xampp\htdocs\fd\resources\css\imageMenu\_imageMenuDesktop.scss", "SCSS", 274, 0, 60, 15, 349
"c:\xampp\htdocs\fd\resources\css\imageMenu\_imageMenuMobile.scss", "SCSS", 361, 0, 49, 20, 430
"c:\xampp\htdocs\fd\resources\css\other\icons.scss", "SCSS", 14, 0, 1, 2, 17
"c:\xampp\htdocs\fd\resources\css\productInformation\_productInformation.scss", "SCSS", 56, 0, 1, 6, 63
"c:\xampp\htdocs\fd\resources\css\themes\theme1\_buttonNew.scss", "SCSS", 140, 0, 6, 15, 161
"c:\xampp\htdocs\fd\resources\css\themes\theme1\_buttons.scss", "SCSS", 59, 0, 1, 7, 67
"c:\xampp\htdocs\fd\resources\css\themes\theme1\_container.scss", "SCSS", 10, 0, 6, 4, 20
"c:\xampp\htdocs\fd\resources\css\themes\theme1\_helper.scss", "SCSS", 26, 0, 0, 13, 39
"c:\xampp\htdocs\fd\resources\css\themes\theme1\_main.scss", "SCSS", 91, 0, 15, 10, 116
"c:\xampp\htdocs\fd\resources\css\themes\theme1\_scrollbar.scss", "SCSS", 19, 0, 4, 3, 26
"c:\xampp\htdocs\fd\resources\css\themes\theme1\_vars.scss", "SCSS", 56, 0, 5, 16, 77
"c:\xampp\htdocs\fd\resources\css\themes\theme2\_buttons.scss", "SCSS", 85, 0, 50, 9, 144
"c:\xampp\htdocs\fd\resources\css\themes\theme2\_main.scss", "SCSS", 58, 0, 9, 8, 75
"c:\xampp\htdocs\fd\resources\css\themes\theme2\_scrollbar.scss", "SCSS", 14, 0, 4, 3, 21
"c:\xampp\htdocs\fd\resources\css\themes\theme2\_vars.scss", "SCSS", 29, 0, 2, 9, 40
"c:\xampp\htdocs\fd\resources\js\3D\3DHelper.js", "JavaScript", 0, -157, -13, -18, -188
"c:\xampp\htdocs\fd\resources\js\3D\commonJS\drawDOMElement_3D.js", "JavaScript", 0, -40, -42, -12, -94
"c:\xampp\htdocs\fd\resources\js\3D\modules\_old\NewProject\Core.js", "JavaScript", 0, -171, -105, -9, -285
"c:\xampp\htdocs\fd\resources\js\3D\modules\_old\NewProject\animations.js", "JavaScript", 0, -247, -28, -6, -281
"c:\xampp\htdocs\fd\resources\js\3D\modules\_old\NewProject\communication.js", "JavaScript", 0, -163, -1, -18, -182
"c:\xampp\htdocs\fd\resources\js\3D\modules\_old\NewProject\light.js", "JavaScript", 0, -67, -52, -18, -137
"c:\xampp\htdocs\fd\resources\js\3D\modules\_old\_index_light_copy.js", "JavaScript", 0, -59, -53, -18, -130
"c:\xampp\htdocs\fd\resources\js\3D\modules\_old\projectNew\Core.js", "JavaScript", 0, -149, -7, -13, -169
"c:\xampp\htdocs\fd\resources\js\3D\modules\_old\projectNew\light.js", "JavaScript", 0, -74, -53, -19, -146
"c:\xampp\htdocs\fd\resources\js\3D\modules\_old\textures.js", "JavaScript", 0, 0, -26, -4, -30
"c:\xampp\htdocs\fd\resources\js\3D\modules\assets\materials\lighter.js", "JavaScript", 0, -204, -363, -28, -595
"c:\xampp\htdocs\fd\resources\js\3D\modules\assets\materials\materials.js", "JavaScript", 0, -143, -88, -14, -245
"c:\xampp\htdocs\fd\resources\js\3D\modules\assets\materials\other.js", "JavaScript", 0, -147, -44, -10, -201
"c:\xampp\htdocs\fd\resources\js\3D\modules\assets\newMaterials\materialsEngraving.js", "JavaScript", 0, -119, -147, -14, -280
"c:\xampp\htdocs\fd\resources\js\3D\modules\assets\newMaterials\materialsLighterGeneral.js", "JavaScript", 0, -224, -91, -20, -335
"c:\xampp\htdocs\fd\resources\js\3D\modules\assets\workerInterface.js", "JavaScript", 0, -49, -15, -2, -66
"c:\xampp\htdocs\fd\resources\js\3D\modules\background\Core.js", "JavaScript", 0, -93, -4, -8, -105
"c:\xampp\htdocs\fd\resources\js\3D\modules\background\light_bright.js", "JavaScript", 0, -58, -53, -18, -129
"c:\xampp\htdocs\fd\resources\js\3D\modules\background\light_dark.js", "JavaScript", 0, -58, -53, -18, -129
"c:\xampp\htdocs\fd\resources\js\3D\modules\background\light_medium.js", "JavaScript", 0, -58, -53, -18, -129
"c:\xampp\htdocs\fd\resources\js\3D\modules\lighter\animations.js", "JavaScript", 0, -388, -70, -38, -496
"c:\xampp\htdocs\fd\resources\js\3D\modules\lighter\converter\Core.js", "JavaScript", 0, -168, -38, -24, -230
"c:\xampp\htdocs\fd\resources\js\3D\modules\lighter\converter\animations.js", "JavaScript", 0, -302, -25, -5, -332
"c:\xampp\htdocs\fd\resources\js\3D\modules\lighter\converter\communication.js", "JavaScript", 0, -152, -25, -5, -182
"c:\xampp\htdocs\fd\resources\js\3D\modules\lighter\converter\light.js", "JavaScript", 0, -64, -54, -17, -135
"c:\xampp\htdocs\fd\resources\js\3D\modules\lighter\index\Core.js", "JavaScript", 0, -253, -230, -58, -541
"c:\xampp\htdocs\fd\resources\js\3D\modules\lighter\index\animations.js", "JavaScript", 0, -441, -45, -7, -493
"c:\xampp\htdocs\fd\resources\js\3D\modules\lighter\index\communication.js", "JavaScript", 0, -70, -100, -5, -175
"c:\xampp\htdocs\fd\resources\js\3D\modules\lighter\index\communication_funcs\core.js", "JavaScript", 0, -30, 0, -1, -31
"c:\xampp\htdocs\fd\resources\js\3D\modules\lighter\index\communication_funcs\desktop.js", "JavaScript", 0, -113, -1, -1, -115
"c:\xampp\htdocs\fd\resources\js\3D\modules\lighter\index\communication_funcs\mobile.js", "JavaScript", 0, -114, -1, -1, -116
"c:\xampp\htdocs\fd\resources\js\3D\modules\lighter\index\light.js", "JavaScript", 0, -81, -55, -18, -154
"c:\xampp\htdocs\fd\resources\js\3D\modules\lighter\model\LighterModel.js", "JavaScript", 0, -164, -4, -5, -173
"c:\xampp\htdocs\fd\resources\js\3D\modules\lighter\model\LighterThumbnail.js", "JavaScript", 0, -95, -2, -15, -112
"c:\xampp\htdocs\fd\resources\js\3D\modules\lighter\project\Core.js", "JavaScript", 0, -221, -47, -21, -289
"c:\xampp\htdocs\fd\resources\js\3D\modules\lighter\project\communication.js", "JavaScript", 0, -171, -1, -20, -192
"c:\xampp\htdocs\fd\resources\js\3D\modules\lighter\project\light.js", "JavaScript", 0, -73, -53, -18, -144
"c:\xampp\htdocs\fd\resources\js\3D\modules\lighter\setup.js", "JavaScript", 0, -95, -5, -6, -106
"c:\xampp\htdocs\fd\resources\js\3D\modules\module_3D_init.js", "JavaScript", 0, -75, -11, -10, -96
"c:\xampp\htdocs\fd\resources\js\ADMIN\Designs\AdminProjectList.js", "JavaScript", 0, -440, -22, -19, -481
"c:\xampp\htdocs\fd\resources\js\ADMIN\Eventhandler.js", "JavaScript", 0, -43, -4, -6, -53
"c:\xampp\htdocs\fd\resources\js\ADMIN\assets\AdminChartTemplate.js", "JavaScript", 0, -17, -5, -4, -26
"c:\xampp\htdocs\fd\resources\js\ADMIN\assets\AdminLogin.js", "JavaScript", 0, -65, 0, -2, -67
"c:\xampp\htdocs\fd\resources\js\ADMIN\assets\AdminNavigation.js", "JavaScript", 0, -66, -1, -3, -70
"c:\xampp\htdocs\fd\resources\js\ADMIN\assets\AdminPaths.js", "JavaScript", 0, -18, 0, -5, -23
"c:\xampp\htdocs\fd\resources\js\ADMIN\assets\AdminTemplate.js", "JavaScript", 0, -36, 0, -3, -39
"c:\xampp\htdocs\fd\resources\js\ADMIN\order\orderDetails.js", "JavaScript", 0, -224, -11, -26, -261
"c:\xampp\htdocs\fd\resources\js\ADMIN\order\orderList.js", "JavaScript", 0, -249, -26, -8, -283
"c:\xampp\htdocs\fd\resources\js\ADMIN\pages\ADMIN_couponCodes.js", "JavaScript", 0, -75, -2, -9, -86
"c:\xampp\htdocs\fd\resources\js\ADMIN\pages\ADMIN_designs.js", "JavaScript", 0, -26, 0, 0, -26
"c:\xampp\htdocs\fd\resources\js\ADMIN\pages\ADMIN_engraving.js", "JavaScript", 0, -19, -1, -3, -23
"c:\xampp\htdocs\fd\resources\js\ADMIN\pages\ADMIN_index.js", "JavaScript", 0, -22, 0, -3, -25
"c:\xampp\htdocs\fd\resources\js\ADMIN\pages\ADMIN_login.js", "JavaScript", 0, -133, -2, -8, -143
"c:\xampp\htdocs\fd\resources\js\ADMIN\pages\ADMIN_orders.js", "JavaScript", 0, -45, -1, -2, -48
"c:\xampp\htdocs\fd\resources\js\ADMIN\pages\ADMIN_products.js", "JavaScript", 0, -279, -7, -26, -312
"c:\xampp\htdocs\fd\resources\js\ADMIN\pages\ADMIN_statistics.js", "JavaScript", 0, -46, -6, -7, -59
"c:\xampp\htdocs\fd\resources\js\ADMIN\pages\ADMIN_stripe.js", "JavaScript", 0, -7, 0, -1, -8
"c:\xampp\htdocs\fd\resources\js\ADMIN\pages\ADMIN_stripeSuccess.js", "JavaScript", 0, -11, -25, -4, -40
"c:\xampp\htdocs\fd\resources\js\ADMIN\pages\ADMIN_testSpace.js", "JavaScript", 0, -53, -5, -7, -65
"c:\xampp\htdocs\fd\resources\js\ADMIN\pages\ADMIN_userAccounts.js", "JavaScript", 0, -5, -2, -1, -8
"c:\xampp\htdocs\fd\resources\js\ADMIN\products\productColorMenu.js", "JavaScript", 0, -74, -3, -8, -85
"c:\xampp\htdocs\fd\resources\js\ADMIN\products\productEPTypeMenu.js", "JavaScript", 0, -74, -3, -8, -85
"c:\xampp\htdocs\fd\resources\js\ADMIN\products\productList.js", "JavaScript", 0, -93, -12, -7, -112
"c:\xampp\htdocs\fd\resources\js\ADMIN\statistics\statisticsHelper.js", "JavaScript", 0, -64, 0, -1, -65
"c:\xampp\htdocs\fd\resources\js\ADMIN\testspace\c_test.js", "JavaScript", 0, -17, 0, -1, -18
"c:\xampp\htdocs\fd\resources\js\ADMIN\testspace\imap.js", "JavaScript", 0, -3, 0, -1, -4
"c:\xampp\htdocs\fd\resources\js\ADMIN\testspace\main.js", "JavaScript", 0, -52, -34, -7, -93
"c:\xampp\htdocs\fd\resources\js\ADMIN\testspace\stripe\stripeMain.js", "JavaScript", 0, -5, 0, -3, -8
"c:\xampp\htdocs\fd\resources\js\ADMIN\testspace\test_chartJS.js", "JavaScript", 0, -49, -2, -2, -53
"c:\xampp\htdocs\fd\resources\js\ADMIN\testspace\test_moonraker.js", "JavaScript", 0, 0, 0, -1, -1
"c:\xampp\htdocs\fd\resources\js\ADMIN\testspace\test_nesting.js", "JavaScript", 0, -84, -20, -11, -115
"c:\xampp\htdocs\fd\resources\js\Checkout\Checkout.js", "JavaScript", 0, -295, -3, -23, -321
"c:\xampp\htdocs\fd\resources\js\Checkout\CheckoutHelper.js", "JavaScript", 0, -103, -102, -24, -229
"c:\xampp\htdocs\fd\resources\js\Checkout\CheckoutRight.js", "JavaScript", 0, -127, -10, -15, -152
"c:\xampp\htdocs\fd\resources\js\Checkout\elements\drawCheckoutHead.js", "JavaScript", 0, -79, -2, -11, -92
"c:\xampp\htdocs\fd\resources\js\Checkout\elements\drawFastCheckout.js", "JavaScript", 0, -9, 0, 0, -9
"c:\xampp\htdocs\fd\resources\js\Checkout\elements\drawMobileProductOverview.js", "JavaScript", 0, -46, -11, -5, -62
"c:\xampp\htdocs\fd\resources\js\Checkout\elements\drawSavedInformation.js", "JavaScript", 0, -138, -3, -21, -162
"c:\xampp\htdocs\fd\resources\js\Codes\CouponCodes.js", "JavaScript", 0, -46, 0, -4, -50
"c:\xampp\htdocs\fd\resources\js\Converter\Converter.js", "JavaScript", 0, -139, -8, -18, -165
"c:\xampp\htdocs\fd\resources\js\Converter\ConverterCloseButtons.js", "JavaScript", 0, -198, -8, -11, -217
"c:\xampp\htdocs\fd\resources\js\Converter\ConverterHelper.js", "JavaScript", 0, -121, -20, -8, -149
"c:\xampp\htdocs\fd\resources\js\Converter\Converter_LeftBar.js", "JavaScript", 0, -91, -4, -8, -103
"c:\xampp\htdocs\fd\resources\js\Converter\DataStorage\C_Image.js", "JavaScript", 0, -61, -5, -3, -69
"c:\xampp\htdocs\fd\resources\js\Converter\DataStorage\C_Text.js", "JavaScript", 0, -49, 0, -2, -51
"c:\xampp\htdocs\fd\resources\js\Converter\DataStorage\DSController.js", "JavaScript", 0, -55, -1, -2, -58
"c:\xampp\htdocs\fd\resources\js\Converter\DataStorage\DSImage.js", "JavaScript", 0, -112, 0, -1, -113
"c:\xampp\htdocs\fd\resources\js\Converter\DataStorage\DSProject.js", "JavaScript", 0, -80, -8, -4, -92
"c:\xampp\htdocs\fd\resources\js\Converter\DataStorage\DSText.js", "JavaScript", 0, -95, -3, -3, -101
"c:\xampp\htdocs\fd\resources\js\Converter\DragAndDrop.js", "JavaScript", 0, 0, -38, -7, -45
"c:\xampp\htdocs\fd\resources\js\Converter\drawElements\drawDesktop.js", "JavaScript", 0, -20, -2, -6, -28
"c:\xampp\htdocs\fd\resources\js\Converter\drawElements\drawMobile.js", "JavaScript", 0, -20, 0, -6, -26
"c:\xampp\htdocs\fd\resources\js\Converter\renderer\ConverterEvents.js", "JavaScript", 0, -132, -17, -4, -153
"c:\xampp\htdocs\fd\resources\js\Converter\renderer\ConverterRender.js", "JavaScript", 0, -712, -42, -34, -788
"c:\xampp\htdocs\fd\resources\js\Converter\renderer\ConverterRenderWorker.js", "JavaScript", 0, -30, -4, -4, -38
"c:\xampp\htdocs\fd\resources\js\Converter\renderer\ConverterTouchEvents.js", "JavaScript", 0, -139, -24, -3, -166
"c:\xampp\htdocs\fd\resources\js\Converter\renderer\handler\ConverterKeyHandler.js", "JavaScript", 0, -37, 0, -1, -38
"c:\xampp\htdocs\fd\resources\js\Converter\renderer\handler\ConverterMouseHandler.js", "JavaScript", 0, -31, 0, -2, -33
"c:\xampp\htdocs\fd\resources\js\Converter\renderer\handler\ConverterTouchHandler.js", "JavaScript", 0, -70, -14, -2, -86
"c:\xampp\htdocs\fd\resources\js\Converter\renderer\helper\CanvasPaths.js", "JavaScript", 0, -268, -28, -26, -322
"c:\xampp\htdocs\fd\resources\js\Converter\renderer\helper\ConverterComputeEdges.js", "JavaScript", 0, -166, -14, -9, -189
"c:\xampp\htdocs\fd\resources\js\Converter\renderer\helper\ConverterDrawHelper.js", "JavaScript", 0, -34, -30, -6, -70
"c:\xampp\htdocs\fd\resources\js\Converter\renderer\helper\lines\ConverterLine.js", "JavaScript", 0, -60, -10, -7, -77
"c:\xampp\htdocs\fd\resources\js\Converter\renderer\helper\lines\ConverterLinesHelper.js", "JavaScript", 0, -29, -5, -2, -36
"c:\xampp\htdocs\fd\resources\js\Converter\toolBar\adminBar.js", "JavaScript", 0, -408, -9, -53, -470
"c:\xampp\htdocs\fd\resources\js\Converter\toolBar\bottom\bottomBar.js", "JavaScript", 0, -59, -10, -1, -70
"c:\xampp\htdocs\fd\resources\js\Converter\toolBar\bottom\bottomBarDraw.js", "JavaScript", 0, -36, 0, -3, -39
"c:\xampp\htdocs\fd\resources\js\Converter\toolBar\bottom\draw\bottomBarImage.js", "JavaScript", 0, -115, -17, -12, -144
"c:\xampp\htdocs\fd\resources\js\Converter\toolBar\bottom\draw\bottomBarStandard.js", "JavaScript", 0, -155, -9, -9, -173
"c:\xampp\htdocs\fd\resources\js\Converter\toolBar\bottom\draw\bottomBarText.js", "JavaScript", 0, -91, -9, -13, -113
"c:\xampp\htdocs\fd\resources\js\Converter\toolBar\bottom\draw\bottomBarTextButtons.js", "JavaScript", 0, -109, 0, -13, -122
"c:\xampp\htdocs\fd\resources\js\Converter\toolBar\bottom\draw\bottomBarTextFontFamilyMenu.js", "JavaScript", 0, -44, 0, -5, -49
"c:\xampp\htdocs\fd\resources\js\Converter\toolBar\bottom\draw\helper.js", "JavaScript", 0, -53, -23, -9, -85
"c:\xampp\htdocs\fd\resources\js\Converter\toolBar\drawParts\ImageParts.js", "JavaScript", 0, -68, 0, 0, -68
"c:\xampp\htdocs\fd\resources\js\Converter\toolBar\drawParts\TextParts.js", "JavaScript", 0, -77, -14, -10, -101
"c:\xampp\htdocs\fd\resources\js\Converter\toolBar\side\LighterSettings.js", "JavaScript", 0, -132, -1, -13, -146
"c:\xampp\htdocs\fd\resources\js\Converter\toolBar\side\image\ImageElement_desktop.js", "JavaScript", 0, -200, -12, -17, -229
"c:\xampp\htdocs\fd\resources\js\Converter\toolBar\side\image\toolBarImage.js", "JavaScript", 0, -97, -1, -4, -102
"c:\xampp\htdocs\fd\resources\js\Converter\toolBar\side\sideBar.js", "JavaScript", 0, -65, 0, -2, -67
"c:\xampp\htdocs\fd\resources\js\Converter\toolBar\side\text\TextElement_desktop copy.js", "JavaScript", 0, -280, -10, -28, -318
"c:\xampp\htdocs\fd\resources\js\Converter\toolBar\side\text\TextElement_desktop.js", "JavaScript", 0, 0, -265, -30, -295
"c:\xampp\htdocs\fd\resources\js\Converter\toolBar\side\text\toolBarText.js", "JavaScript", 0, -79, -1, -4, -84
"c:\xampp\htdocs\fd\resources\js\Converter\toolBar\toolBar.js", "JavaScript", 0, -39, -2, -4, -45
"c:\xampp\htdocs\fd\resources\js\Converter\toolBar\tools\ImageTools.js", "JavaScript", 0, -23, 0, -2, -25
"c:\xampp\htdocs\fd\resources\js\Converter\toolBar\tools\TextTools.js", "JavaScript", 0, -46, -3, -1, -50
"c:\xampp\htdocs\fd\resources\js\Converter\worker\_ConverterWorker.js", "JavaScript", 0, -38, -48, -11, -97
"c:\xampp\htdocs\fd\resources\js\Converter\worker\_ConverterWorkerHelper.js", "JavaScript", 0, -69, -11, -9, -89
"c:\xampp\htdocs\fd\resources\js\Designs\CategoryHelper.js", "JavaScript", 0, -24, 0, 0, -24
"c:\xampp\htdocs\fd\resources\js\Designs\DesignHelper.js", "JavaScript", 0, -82, 0, -4, -86
"c:\xampp\htdocs\fd\resources\js\Designs\ImageMenu\ImageHelper.js", "JavaScript", 0, -58, -1, -4, -63
"c:\xampp\htdocs\fd\resources\js\Designs\ImageMenu\ImageMenu.js", "JavaScript", 0, -208, -27, -20, -255
"c:\xampp\htdocs\fd\resources\js\Designs\ImageMenu\ImageMenuFilter.js", "JavaScript", 0, -37, 0, -2, -39
"c:\xampp\htdocs\fd\resources\js\Designs\ImageMenu\Unsplash.js", "JavaScript", 0, -142, -15, -6, -163
"c:\xampp\htdocs\fd\resources\js\Email\Email.js", "JavaScript", 0, -17, 0, -1, -18
"c:\xampp\htdocs\fd\resources\js\Eventhandler.js", "JavaScript", 0, -92, -2, -6, -100
"c:\xampp\htdocs\fd\resources\js\Footer.js", "JavaScript", 0, -80, 0, -3, -83
"c:\xampp\htdocs\fd\resources\js\GLOBAL\Paths.js", "JavaScript", 0, -95, -6, -33, -134
"c:\xampp\htdocs\fd\resources\js\Helper\ProjectsHelper.js", "JavaScript", 0, -140, -1, -4, -145
"c:\xampp\htdocs\fd\resources\js\Helper\ProjectsHelperDesign.js", "JavaScript", 0, -48, 0, -1, -49
"c:\xampp\htdocs\fd\resources\js\Login\LoginHelper.js", "JavaScript", 0, -67, -25, -8, -100
"c:\xampp\htdocs\fd\resources\js\NavigationBar.js", "JavaScript", 0, -123, -3, -6, -132
"c:\xampp\htdocs\fd\resources\js\Orders\Order.js", "JavaScript", 0, -95, 0, -6, -101
"c:\xampp\htdocs\fd\resources\js\Pages\cart\cart.js", "JavaScript", 0, -21, -6, -4, -31
"c:\xampp\htdocs\fd\resources\js\Pages\cart\cartList.js", "JavaScript", 0, -118, -33, -15, -166
"c:\xampp\htdocs\fd\resources\js\Pages\cart\cartRight.js", "JavaScript", 0, -63, -4, -7, -74
"c:\xampp\htdocs\fd\resources\js\Pages\converterStart.js", "JavaScript", 0, -19, -5, -1, -25
"c:\xampp\htdocs\fd\resources\js\Pages\imprint.js", "JavaScript", 0, -36, -1, -6, -43
"c:\xampp\htdocs\fd\resources\js\Pages\index\index.js", "JavaScript", 0, -58, -12, -14, -84
"c:\xampp\htdocs\fd\resources\js\Pages\index\overlay.js", "JavaScript", 0, -292, -11, -11, -314
"c:\xampp\htdocs\fd\resources\js\Pages\pagesTemplate.js", "JavaScript", 0, -13, 0, -1, -14
"c:\xampp\htdocs\fd\resources\js\Pages\paymentComplete\paymentComplete.js", "JavaScript", 0, -30, -7, -4, -41
"c:\xampp\htdocs\fd\resources\js\Projects\ProjectList\Details\ProjectDetailsDesktop.js", "JavaScript", 0, -332, -30, -40, -402
"c:\xampp\htdocs\fd\resources\js\Projects\ProjectList\Details\ProjectDetailsHelper.js", "JavaScript", 0, -109, -3, -7, -119
"c:\xampp\htdocs\fd\resources\js\Projects\ProjectList\Details\ProjectDetailsMobile.js", "JavaScript", 0, -169, -49, -24, -242
"c:\xampp\htdocs\fd\resources\js\Projects\ProjectList\ProjectCategoryMenu.js", "JavaScript", 0, -129, -46, -5, -180
"c:\xampp\htdocs\fd\resources\js\Projects\ProjectList\ProjectChoiceMenu.js", "JavaScript", 0, -259, -20, -21, -300
"c:\xampp\htdocs\fd\resources\js\Projects\ProjectList\ProjectDetails.js", "JavaScript", 0, -26, 0, -1, -27
"c:\xampp\htdocs\fd\resources\js\Projects\ProjectList\ProjectList.js", "JavaScript", 0, -126, -18, -10, -154
"c:\xampp\htdocs\fd\resources\js\Projects\Projects.js", "JavaScript", 0, -14, -3, -2, -19
"c:\xampp\htdocs\fd\resources\js\_WebWorker\SVGGeneratorWorker.js", "JavaScript", 0, -16, -4, -3, -23
"c:\xampp\htdocs\fd\resources\js\_WebWorker\normalMapWorker.js", "JavaScript", 0, -94, -4, -13, -111
"c:\xampp\htdocs\fd\resources\js\assets\UserData.js", "JavaScript", 0, -81, 0, -2, -83
"c:\xampp\htdocs\fd\resources\js\assets\functionsCouponCode.js", "JavaScript", 0, -83, 0, -3, -86
"c:\xampp\htdocs\fd\resources\js\assets\functionsHashtag.js", "JavaScript", 0, -37, 0, -2, -39
"c:\xampp\htdocs\fd\resources\js\assets\functionsProduct.js", "JavaScript", 0, -53, -2, -6, -61
"c:\xampp\htdocs\fd\resources\js\assets\functionsShoppingCart.js", "JavaScript", 0, -159, 0, -4, -163
"c:\xampp\htdocs\fd\resources\js\assets\product\productHelper.js", "JavaScript", 0, -136, 0, -7, -143
"c:\xampp\htdocs\fd\resources\js\lexOffice\lexOffice.js", "JavaScript", 0, -19, 0, -3, -22
"c:\xampp\htdocs\fd\resources\js\lexOffice\lexOfficeGenerateData.js", "JavaScript", 0, -150, -105, -30, -285
"c:\xampp\htdocs\fd\resources\js\lexOffice\lexOfficeHelper.js", "JavaScript", 0, -17, -4, -1, -22
"c:\xampp\htdocs\fd\resources\js\manager\manager.js", "JavaScript", 0, -28, -27, -5, -60
"c:\xampp\htdocs\fd\resources\js\manager\managerCallPHP.js", "JavaScript", 0, -55, -18, -4, -77
"c:\xampp\htdocs\fd\resources\js\manager\managerHelper.js", "JavaScript", 0, -36, -19, -9, -64
"c:\xampp\htdocs\fd\resources\js\manager\managerListener.js", "JavaScript", 0, 0, -51, -5, -56
"c:\xampp\htdocs\fd\resources\js\manager\managerObject.js", "JavaScript", 0, -88, -1, -1, -90
"c:\xampp\htdocs\fd\resources\js\manager\managerPageObject.js", "JavaScript", 0, -8, -1, -1, -10
"c:\xampp\htdocs\fd\resources\js\old\SVG_anmiation_test.js", "JavaScript", 0, -138, -2, -25, -165
"c:\xampp\htdocs\fd\resources\js\old\drawProductInformation.js", "JavaScript", 0, 0, -13, -2, -15
"Total", "-", 13843, -17939, -1410, -691, -6197